10 10
1 1 1 1 1 1 1 1 1 1
1 3 3 3 1 1 3 3 3 1
1 3 10 3 1 1 3 10 3 1
1 3 3 3 1 1 3 3 3 1
1 1 1 1 1 1 1 1 1 1
1 1 1 1 1 1 1 1 1 1
1 3 3 3 1 1 3 3 3 1
1 3 10 3 1 1 3 10 3 1
1 3 3 3 1 1 3 3 3 1
1 1 1 1 1 1 1 1 1 1

2,2 7,7
5,5

0,5 1,5 2,5 3,5 4,5 5,5 6,5 7,5 8,5 9,5

10:5,5:999 15:2,2:10