5 5
1 1 1 1 1
1 3 3 3 1
1 3 10 3 1
1 3 3 3 1
1 1 1 1 1

1,1
3,3

0,2 1,2 2,2 3,2 4,2

5:2,2:999